000000000000000000000000000000000000000000000000
000000000000000000000000000000000000000000000000
000000000000000000000000000000000000000000000000
000000000000000000000000000000000000000000000000
000000000000000000000000000000000000000000000000
000000000000000000000000000000000000000000000000
000000000000000000000000000000000000000000000000
000000000000000000000000000000000000000000000000
000000000000000000000000000000000000000000000000
000000000000000000000000000000000000000000000000
000000000000000000000000000000000000000000000000
000000000000000000000000000000000000000000000000
000000000000000000000000000000000000000000000000
000000000000000000000000000000000000000000000000
000000000000000000000000000000000000000000000000
000000000000000000000000000000000000000000000000
000000000000000000000000000000000000000000000000
00000000T000000000000000000000000000000000000000
0!!!!!!!!!!!!!!!!0000000000000000000000000000000
000000000000000000000000000000000000000000000000
00000000000000000000!!!!!!!!!!!!!!00000000000000
000000000000000000000000000000000000000000000000
000000000000000000000000000000000000000000000000
0000=00000000000000000000000000000B0000000000000
################################################
################################################
################################################
