000000000000000000000000000000000000000000000000000000000000000000000000000000000
000000000000000000000000000000000000000000000000000000000000000000000000000000000
000000000000000000000000000000000000000000000000000000000000000000000000000000000
000000000000000000000000000000000000000000000000000!!!!!!!!!!!!!!0000000000000000
!!!!!!!!!!!!!!0000000000000000000000000000000000000000000000000000000000000000000
000000000000000000000000000000000000000000000000000000000000000000000000000000000
0000000000000000000000000000000000000000000000000000000000000000000000!!!!!!!!!00
000000000000000000000000000000000000000000000000000000000000000000000000000000000
00000000000000000000000000E000001000000000000000000000200000000000000000000000000
!!!!!00000000000000!!!!!!!!!!!!!!!!!!!!!!!!!!!!!!!!!!!!!0000000000000000000000000
000000000000000000000000000000000000000000000000000000000000000000000000000000000
0000000000000000000000000000000000000000000000000000000000000000000000000000!!!00
000000000000000000000000000000000000000000000000000000000000000000000000000000000
000000000000000000000000000000000000000000000000000000000000000000000000000000000
00000000000000000*000000000000000000000000000000000000000000000000000000000000000
00000000000!!!!!!!!!!!00000000000000000000000000000!!!!!!!!!!!!!!!000000000000000
000000000000000000000000000000000000000000000000000000000000000000000000000000000
000000000000000000000000000000000000000000000000000000000000000000000000000000000
!!!!!0000000000000000000000000000000000000000000000000000000000000000000000000000
0000000000000!!!!!!!!!!!!!!!!!!!!!!!!!!!!0000000000000000000000000000000000000000
000000000000000000000000000000000000000000000000000000000000000000000000000000000
000000000000000000000000000000000000000000000000000000000000000000000!!!!!!!!!!00
000000000000000000000000000000000000000000000000000000000000000000000000000000000
000000000000000000000000000000000000000000000000000000000000000000000000000000000
!!!!!!000000000000000000000000000000000000000000000000000000000000000000000000000
00000000000000000000000000000000000!!!!!!!!!!!!!!!!!!!!!!!!!!!!!!!!!!!!!000000000
00000000000=000000000000000000000000000000000000000000000000000000000000000000000
#################################################################################

