!!!!!!!!!!!!!!!!!!!!!!!!!!!!!!!!!!!!!!!!!!!!!!!!!!!!!!!!!!!!!!!!!!!!!!!!!!!!!!!!!!!!!!!!!
!000000000000000000000000000000000000000000000000000000000000000000000000000000000000000!
!000000000000000000000000000000000000000000000000000000000000000000000000000000000000000!
!000000000000000000000000000000000000000000000000000000000000000000000000000000000000000!
!000000000000000000000000000000000000000000000000000000000000000000000000000000000000000!
!000000000000000000000000000000000000000000000000000000000000000000000000000000000000000!
!000000000000000000000000000000000000000000000000000000000000000000000000000000000000000!
!0000000000E0000000000000000000000000000000000000000000000000000000000000000000000000000!
!000000000000000000000000000000000000000000000000000000000000000000000000000000000000000!
!000000000000000000000000000000000000000000000000000000000000000000000000000000000000000!
!000000000000000000000000000000000000000000000000000000000000000000000000000000000000000!
!000000000000000000000000000000000000000000000000000000000000000000000000000000000000000!
!000000000000000000000000000000000000000000000000000000000000000000000000000000000000000!
!000000000000000000000000000000000000000000000000000000000000000000000000000000000000000!
!0000000000000000*0000000000000000000000000000000000000000000000000000000000000000000000!
!0000000000!!!!!!!!!!!000000000000000000000000000000000000000000000000000000000000000000!
!000000000000000000000000000000000000000000000000000000000000000000000000000000000000000!
!000000000000000000000000000000000000000000000000000000000000000000000000000000000000000!
!000000000000000000000000000000000000000000000000000000000000000000000000000000000000000!
!000000000000000000000000000000000000000000000000000000000000000000000000000000000000000!
!000000000000000000000000000000000000000000000000000000000000000000000000000000000000000!
!000000000000000000000000000000000000000000000000000000000000000000000000000000000000000!
!000000000000000000000000000000000000000000000000000000000000000000000000000000000000000!
!000000000000000000000000000000000000000000000000000000000000000000000000000000000000000!
!000000000000000000000000000000000000000000000000000000000000000000000000000000000000000!
!000000000000000000000000000000000000000000000000000000000000000000000000000000000000000!
!000000=00000000000000000000000000000000000000000000000000000000000000000000000000000000!
#########################################################################################

