0000000000000000000000000000000000000000000000000000000000000000
0000000000000000000000000000000000000000000000000000000000000000
00000000000!!!!!!!!!0000000000000000000!!!!!!!!!!!!!!!!!!!!!!!!!
0000000000000000000000000000000000000000000000000000000000000000
0000000000000000000000000000000000000000000000000000000000000000
!!!!!!!!00000000000000000000000000000000000!!!!!!!!!!!!!!!!!!!!!
0000000000000000000000000000000000000000000000000000000000000000
00000000000000!!!!!!!!!!!!!!!!0000000000000000000000000000000000
000000000000000000000000000000!!!!!!!000000000000000000000000000
0000000!!!!!!!!0000000000000000000000000000000000000000000000000
000000000000000000000000000000000000000000!!!!!!!!!!!!!!!!!!!!!!
00000000E0000000000000000000000000000000000000000000000000000000
!!!!!!!!!!!!!!!!!!!!!!!!0000000000000000000000000000000000000000
00000000000000000000000000000000!!!!!!!!!!!!!!!!!!!!!!!!!!!!!!!!
0000000000000000000000000000000000000000000000000000000000000000
00000000000!!!!!!!!!!!!!!!!!!!0000000000000000000000000000000000
0000000000000000000000000000000000000000000000000000000000000000
000000000000000000000000000000000!!!!!!!!!!!!!!!!000000000000000
0000000000000000000000000000000000000000000000000000000000000000
0000000!!!!!!!!!!!!!!!!!!!!!!!0000000000000000000000000000000000
0000000000000000000000000000000000000000000000000000000000000000
0000000000000000000000000000000000*00000000000000000000000000000
!!!!!!!!!!000000000000000!!!!!!!!!!!!!!!!!!!!!!!!!!!!!!!!!!!!!!!
0000000000000000000000000000000000000000000000000000000000000000
0000000000000000000000000000000000000000000000000000000000000000
0000000!!!!!!!!!!!!!!!!!!!!!!!0000000000000000000000000000000000
0000000000000000000000000000000000000000000000000000000000000000
!!!!!!!!!!000000000000000!!!!!!!!!!!!!!!!!!!!!!!!!!!!!!!!!!!!!!!
0000000000000000000000000000000000000000000000000000000000000000
0000000000000000000000000000000000000000000000000000000000000000
000=000000000000000000000000000000000000000000000000000000000000
#################################################################
